p	p
b	b
ɓ	ʔb
m	m
w	w
f	f
v	v
ⱱ	ⱱ
t	t
s	s
d	d
ɗ	dʔ
n	n
z	z
r	ɾ
l	l
c	t͡ʃ
j	d͡ʒ
y	j
k	k
g	ɡ
ŋ	ŋ
'	ʔ
h	h
i	i
ii	iː
ĩĩ	ĩː
e	ɛ
ee	ɛː
ẽ	ɛ̃
ə	ɨ
əə	ɨː
ə̃	ɨ̃
a	a
aa	aː
ã	ã
u	u
uu	uː
o	ɔ
oo	ɔː
õ	ɔ̃
,	(.)
(.)	(.)
.	(.)
!	(.)
